Census Tracts:
01 - 000301
02 - 001500
03 - 004101
04 - 008306
05 - 000902
06 - 002100
07 - 004304
08 - 004603
09 - 003001
10 - 006809