Tract list:
01 - 000301 & 000302
02 - 001500
03 - 004101 & 004103
04 - 008304 & 008306
05 - 000902
06 - 002100 & 002802
07 - 004304
08 - 004603 & 004700
09 - 003001 & 003002
10 - 006809