Census Tracts:
01 - 010220
02 - 020651
03 - 002000
04 - 002600
05 - 002900
06 - 011600
07 - 006800
08 - 022500
09 - 010810
10 - 021747