Census Tracts:
01 - 008700
02 - 009501
03 - 004900
04 - 004300
05 - 006902
06 - 012501
07 - 012003
08 - 012800
09 - 013600
10 - 013900