Census Tracts:
01 - 050200
02 - 020200
03 - 000201
04 - 060800
05 - 070900
06 - 091800
07 - 120104
08 - 092200
09 - 110403
10 - 130200