Tract list:
01 - 007208
02 - 008204
03 - 008010
04 - 006600
05 - 005702
06 - 008905
07 - 002300
08 - 004801 & 004802
09 - 009308
10 - 009324