Tract list:
01 - 010011 & 010012
02 - 001103 & 001104
03 - 009311 & 000708
04 - 004701 & 004702
05 - 002800
06 - 005901 & 005904
07 - 007902
08 - 007806 & 008101
09 - 008208 & 008209
10 - 011202